11000000000
01000000000
01110000000
00011111000
00010001000
01000001000
01000001000
01110001000
00010000000
00010000000
